...###.####..###....
..##.#.####.##....##
.##..###..#.##.###..
##........#....#####
#...@..#..##.##.....
###..###..#...####..
..#..#....#.#.###...
.##.##.#.##.....####
.#......##..###.....
.#.....##..#####....
